##########....#####
......#####.....###
#####......###.####
##.......#####...##
##..##########..###
#...........#######
.......###....#####
####......#########
#####..############
.......############
\robot 5 1
\robot 1 3
\robot 6 0
