##..###
#.#..##
#...###
#....##
#.#..##
##..###
\robot 2 3
\robot 3 0
\robot 1 4