#########.#
###.......#
#####..##.#
######....#
#......####
#.#########
\robot 1 0
\robot 6 2
\robot 9 5